{
  "world": {
    "backgroundImage": " ",
    "backgroundMusic": " ",
    "tileSet": "images/ClassicRPGTileset/ClassicRPG_Tileset0000.png",
    "tileSize": [ 16, 16 ],
    "tileMapSize": [ 29, 18 ],
    "tilesPerLine": 80,
    "tileMap": [
      [ 13, 13, 13, 13, 13, 13, 13, 13, 13, 13, 13, 13, 1, 2, 2, 2, 2, 13, 13, 13, 13, 13, 13, 13, 13, 13, 13, 13, 76 ],
      [ 13, 13, 13, 13, 13, 13, 13, 13, 13, 13, 13, 13, 4, 5, 5, 5, 6, 13, 13, 13, 13, 13, 13, 13, 13, 13, 13, 13, 76 ],
      [ 13, 13, 13, 13, 13, 13, 13, 13, 13, 13, 13, 13, 4, 5, 5, 5, 6, 13, 13, 13, 13, 13, 13, 13, 13, 13, 13, 13, 76 ],
      [ 13, 13, 13, 13, 13, 13, 13, 13, 13, 13, 13, 13, 4, 5, 5, 5, 6, 13, 13, 13, 13, 13, 13, 13, 13, 13, 13, 13, 76 ],
      [ 13, 13, 13, 13, 13, 13, 13, 13, 13, 13, 13, 13, 4, 5, 5, 5, 6, 13, 13, 13, 13, 13, 13, 70, 13, 13, 13, 13, 76 ],
      [ 13, 13, 13, 13, 13, 13, 13, 13, 13, 13, 13, 13, 4, 5, 5, 5, 6, 13, 13, 13, 13, 13, 13, 13, 13, 13, 13, 13, 76 ],
      [ 13, 13, 13, 13, 13, 13, 13, 13, 13, 13, 13, 13, 4, 5, 5, 5, 6, 13, 13, 13, 13, 13, 13, 13, 13, 13, 13, 13, 76 ],
      [ 13, 13, 13, 13, 13, 13, 13, 13, 13, 13, 13, 13, 4, 5, 5, 5, 6, 13, 13, 13, 13, 13, 13, 13, 13, 13, 13, 13, 76 ],
      [ 13, 13, 13, 13, 13, 13, 13, 13, 13, 13, 13, 13, 4, 5, 5, 5, 6, 13, 13, 13, 13, 13, 13, 13, 13, 13, 13, 13, 76 ],
      [ 13, 13, 13, 13, 13, 13, 13, 13, 13, 13, 13, 13, 4, 5, 5, 5, 6, 13, 13, 13, 13, 13, 13, 13, 13, 13, 13, 13, 76 ],
      [ 13, 13, 13, 13, 13, 13, 13, 13, 13, 13, 13, 13, 4, 5, 5, 5, 6, 13, 13, 13, 13, 13, 13, 13, 13, 13, 13, 13, 76 ],
      [ 13, 13, 13, 13, 13, 13, 13, 13, 13, 13, 13, 13, 4, 5, 5, 5, 6, 13, 13, 13, 13, 13, 13, 13, 13, 13, 13, 13, 76 ],
      [ 13, 13, 13, 13, 13, 13, 13, 13, 13, 13, 13, 13, 4, 5, 5, 5, 6, 13, 13, 13, 13, 13, 13, 13, 13, 13, 13, 13, 76 ],
      [ 13, 13, 13, 13, 13, 13, 13, 13, 13, 13, 13, 13, 4, 5, 5, 5, 6, 13, 13, 13, 13, 13, 13, 13, 13, 13, 13, 13, 76 ],
      [ 12, 13, 13, 13, 13, 13, 13, 13, 13, 13, 13, 13, 4, 5, 5, 5, 6, 13, 13, 13, 13, 13, 13, 13, 13, 13, 13, 13, 76 ],
      [ 12, 13, 13, 13, 13, 13, 13, 13, 13, 13, 13, 13, 4, 5, 5, 5, 6, 13, 13, 13, 13, 13, 13, 13, 13, 13, 13, 13, 76 ],
      [ 13, 13, 13, 13, 13, 13, 13, 13, 13, 13, 13, 13, 4, 5, 5, 5, 6, 13, 13, 13, 13, 13, 13, 13, 13, 13, 13, 13, 76 ],
      [ 13, 13, 13, 13, 13, 13, 13, 13, 13, 13, 13, 13, 7, 8, 8, 8, 9, 12, 12, 12, 13, 13, 13, 13, 13, 13, 13, 13, 76 ]
    ],
    "spawnList": [
      {
        "name": "player_start",
        "position": [ 128, 128 ]
      }
    ]
  }
}